ANTICLOCKWISE	AE N T AY K L AA K W AY Z
BATTERY	B AE T ER IY
CLOCKWISE	K L AA K W AY Z
COUNTERCLOCKWISE	K AW N T ER K L AO K W AY Z
COUNTERCLOCKWISE(2)	K AW N ER K L AO K W AY Z
DATE	D EY T
DOWN	D AW N
INFO	IH N F OW
IS	IH Z
IT	IH T
MUTE	M Y UW T
THE	DH AH
THE(2)	DH IY
TIME	T AY M
TODAY	T AH D EY
TODAY(2)	T UW D EY
TURN	T ER N
UNMUTE	AH N M Y UW T
UP	AH P
VOLTAGE	V OW L T AH JH
VOLTAGE(2)	V OW L T IH JH
VOLUME	V AA L Y UW M
WHAT	W AH T
WHAT(2)	HH W AH T
